01 01 01 01 01 01 01 01 01 01 01 01 01 01 01 01 01 01 01 01 01 01 01 01 01 01 01 01
05 09 09 09 09 09 09 09 09 09 09 09 09 26 25 09 09 09 09 09 09 09 09 09 09 09 09 06
12 02 02 02 02 02 02 02 02 02 02 02 02 18 20 02 02 02 02 02 02 02 02 02 02 02 02 10
12 02 13 19 19 14 02 13 19 19 19 14 02 18 20 02 13 19 19 19 14 02 13 19 19 14 02 10
12 03 18 01 01 20 02 18 01 01 01 20 02 18 20 02 18 01 01 01 20 02 18 01 01 20 03 10
12 02 15 17 17 16 02 15 17 17 17 16 02 15 16 02 15 17 17 17 16 02 15 17 17 16 02 10
12 02 02 02 02 02 02 02 02 02 02 02 02 02 02 02 02 02 02 02 02 02 02 02 02 02 02 10
12 02 13 19 19 14 02 13 14 02 13 19 19 19 19 19 19 14 02 13 14 02 13 19 19 14 02 10
12 02 15 17 17 16 02 18 20 02 15 17 17 14 13 17 17 16 02 18 20 02 15 17 17 16 02 10
12 02 02 02 02 02 02 18 20 02 02 02 02 18 20 02 02 02 02 18 20 02 02 02 02 02 02 10
07 14 02 13 19 14 02 18 15 19 19 14 01 18 20 01 13 19 19 16 20 02 13 19 14 02 13 08
01 12 02 18 01 20 02 18 13 17 17 16 01 15 16 01 15 17 17 14 20 02 18 01 20 02 10 01
01 12 02 18 01 20 02 18 20 01 01 01 01 01 01 01 01 01 01 18 20 02 18 01 20 02 10 01
01 12 02 18 01 20 02 18 20 01 21 11 11 04 04 11 11 22 01 18 20 02 18 01 20 02 10 01
01 12 02 18 01 20 02 15 16 01 10 01 01 01 01 01 01 12 01 15 16 02 18 01 20 02 10 01
01 12 33 18 01 20 02 01 01 01 10 01 01 01 01 01 01 12 01 01 01 02 18 01 20 33 10 01
01 12 02 18 01 20 02 13 14 01 10 01 01 01 01 01 01 12 01 13 14 02 18 01 20 02 10 01
01 12 02 18 01 20 02 18 20 01 23 09 09 09 09 09 09 24 01 18 20 02 18 01 20 02 10 01
01 12 02 18 01 20 02 18 20 01 01 01 01 01 01 01 01 01 01 18 20 02 18 01 20 02 10 01
01 12 02 18 01 20 02 18 20 01 13 19 19 19 19 19 19 14 01 18 20 02 18 01 20 02 10 01
05 16 02 15 17 16 02 15 16 01 15 17 17 14 13 17 17 16 01 15 16 02 15 17 16 02 15 06
12 02 02 02 02 02 02 02 02 02 02 02 02 18 20 02 02 02 02 02 02 02 02 02 02 02 02 10
12 02 13 19 19 14 02 13 19 19 19 14 02 18 20 02 13 19 19 19 14 02 13 19 19 14 02 10
12 02 15 17 14 20 02 15 17 17 17 16 02 15 16 02 15 17 17 17 16 02 18 13 17 16 02 10
12 03 02 02 18 20 02 02 02 02 02 02 02 01 01 02 02 02 02 02 02 02 18 20 02 02 03 10
31 19 14 02 18 20 02 13 14 02 13 19 19 19 19 19 19 14 02 13 14 02 18 20 02 13 19 32
29 17 16 02 15 16 02 18 20 02 15 17 17 14 13 17 17 16 02 18 20 02 15 16 02 15 17 30
12 02 02 02 02 02 02 18 20 02 02 02 02 18 20 02 02 02 02 18 20 02 02 02 02 02 02 10
12 02 13 19 19 19 19 16 15 19 19 14 02 18 20 02 13 19 19 16 15 19 19 19 19 14 02 10
12 02 15 17 17 17 17 17 17 17 17 16 02 15 16 02 15 17 17 17 17 17 17 17 17 16 02 10
12 02 02 02 02 02 02 02 02 02 02 02 02 02 02 02 02 02 02 02 02 02 02 02 02 02 02 10
07 11 11 11 11 11 11 11 11 11 11 11 11 11 11 11 11 11 11 11 11 11 11 11 11 11 11 08
